R 800 800
SO ./textures/wood.xpm
WE ./textures/redbrick.xpm
EA ./textures/stone.xpm
NO ./textures/mossy.xpm 

S2 ./textures/plantgreen.xpm 
S1 ./textures/barrel.xpm    

F  255,255,255

C 0,255,255

111111111111111   111  1111111111111
10030020001111111111111    
10200000301111111111111    
100000N0001111111111111111111
1111020011111111111000001000111111
10010000000000000001111111111
111111111111111111000002100011
11000000001111   111011110201
1111011111111111110000001000111111111
111101111111110111010100100011
110000001101010111000000000011
100020022200000000000000100011111111
100000000000000011010100111111
111000001101010111110111000001
10111011111111101101101110110111
111111111111 11111111111111111
