R  800 800


SO ./textures/wood.xpm
WE ./textures/redbrick.xpm
EA ./textures/stone.xpm
NO ./textures/mossy.xpm 

S ./textures/barrel.xpm    

F 255,255,255

C 0,255,255

111111111111111   111  1111111111111
10000000001111111111111    
10000000001111111111111    
100000N0001111111111111111111
1111000011111111111000001000111111
10010000000000000001111111111
111111111111111111000000100011
11000000001111   111011110001
1111011111111111110000001000111111111
111101111111110111010100100011
110000001101010111000000000011
100000000000000000000000100011111111
100000000000000011010100111111
111000001101010111110111000001
10111011111111101101101110110111
111111111111 11111111111111111
