R 800 800 
SO ./textures/wood.xpm
WE ./textures/redbrick.xpm
EA ./textures/stone.xpm
NO ./textures/mossy.xpm 

S2 ./textures/plantgreen.xpm 
S1 ./textures/barrel.xpm    

F  255,255,255

C 0,255,255

11111111
11111111
111N1111
11111111

